      **  +++++
  **      +++++
  **   *  *****
       *       
      **    ** 
****   *    **+
****      ****+
****     ***** 
****           
      **    ** 
    ***    *** 
    *****++*** 
      ***++*** 
++     ******* 
+++    ******* 
