      **  +++++*****      *++       **  +++++*****      *+++++     ************ +++ ***  *****   *  
  **      +++++*****   ******      ****  **     **      *+++  **      +++++*****   ******      **** 
  **   *  *******     *******       **    **    **          +++    ************ +++  **  ****      *
       *                      ****      ****++**  ****    **  **      +++++*****   ******      **** 
      **    ** ***    **    *+++     ************ +++ ***  *    ***    ***        ****  * +++    ***
****   *    **++** *****    *+    *****++*** ***+   **    **  **      +++++*****   ******      **** 
****      ****++**  ****    ******   *    **++** *****    *+      ***++*** ***+      *****+++    ***
****     ***** ***  ***           ***    ***        ****  **+++    ************ +++  **  *    **    
****               ***    **          **       ***            **      +++++*****   ******      **** 
      **    **    **   ++ **  ****    *****     ***    **   ****     ***** ***  ***           ***   
    ***    ***        ****  * +++    ************ +++  **  *  **      +++++*****   ******      **** 
    *****++*** ***+   **    ******      ****++**  ****    **      ***++*** ***+      *****+++    ***
      ***++*** ***+      *****+++    *******++*** +++  **  *****     ***** ***  ***           ***   
++     ************ +++ ***  *****   *    **++** *****    *+  **      +++++*****   ******      **** 
+++    ************ +++  **  *    **    *+++     ********** +++    ************ +++  **  *    **    
****      ****++**  ****    **    **   ++ **  ****    *****     ***    ***        ****  * +++    ***
****     ***** ***  ***       ********** +++     *    **        ***    ***        ****  * +++    ***
****               ***    **  * +++ ***  *****   *    **    +++    ************ +++  **  *    **    
      **    **    **   ++ **   ***           ***    *           ***    ***        ****  * +++    ***
    ***    ***        ****  * *******  **    **   ++ **  ***+++    ************ +++  **  ****      *
    *****++*** ***+   **    *********++    ************       **      +++++*****   ******      **** 
      ***++*** ***+      ******** ***+      *****  +++   ** ++     ************ +++ ***  *****   *  
++     ************ +++ ***  ********* +++ ***     +++   **     ***    ***        ****  * +++    ***
** +++  **  *          **     ***   ++**    *     **    * **      ***++*** ***+      *****+++    ***
****      ****++**  ****    **   ++ **  ****    ***         ++     ************ +++ ***  *****   *  
****     ***** ***  ***       **  ***       **********      ****     ***** ***  ***       **  ***   
****               ***    **        **  ****    ***      ***    ***    ***        ****  * +++    ***
  **      +++++*****   ******      ****  **     **      *+++  **      +++++*****   ******      **** 
  **   *  *******     *******       **    **    **          +++    ************ +++  **  ****      *
       *                      ****      ****++**  ****    **    ***    ***        ****  * +++    ***
      **    ** ***    **    *+++     ************ +++ ***  *****     ***** ***  ***       **  ***   
****   *    **++** *****    *+    *****++*** ***+   **    ******     ***** ***  ***           ***   
****               ***    **          **       ***                ***++*** ***+      *****+++    ***
      **    **    **   ++ **  ****    *****     ***    **   ****     ***** ***  ***       **  ***   
    ***    ***        ****  * +++    ************ +++  **  *****     ***** ***  ***           ***   
    *****++*** ***+   **    ******      ****++**  ****    **+++    ************ +++  **  *    **    
      ***++*** ***+      *****+++    *******++*** +++  **  *    ***    ***        ****  * +++    ***
++     ************ +++ ***  *****   *    **++** *****    *+  **      +++++*****   ******      **** 
+++    ************ +++  **  *    **    *+++     **********   **      +++++*****   ******      **** 
****      ****++**  ****    **    **   ++ **  ****    ***** +++    ************ +++  **  *    **    
****     ***** ***  ***       ********** +++     *    **        ***    ***        ****  * +++    ***
****               ***    **  * +++ ***  *****   *    **    +++    ************ +++  **  *    **    
      **    **    **   ++ **   ***           ***    *       ****     ***** ***  ***       **  ***   
    ***    ***        ****  * *******  **    **   ++ **  *** ****    ***         ****     ***** *** 
    *****++*** ***+   **    *********++    ************     ++     ************ +++ ***  *****   *  
      ***++*** ***+      ******** ***+      *****  +++   ** **      ****++**  ****    **    ***    *
++     ************ +++ ***  ********* +++ ***     +++   **     ***    ***        ****  * +++    ***
+++    ************ +++  **  ****      ****++**  ****    ** +++    ************ +++  **  ****      *
** +++  **  *          **     ***   ++**    *     **    * ******     ***** ***  ***           ***   
****      ****++**  ****    **   ++ **  ****    ***         ****     ***** ***  ***           ***   
****     ***** ***  ***       **  ***       **********      ++     ************ +++ ***  *****   *  
****               ***    **        **  ****    ***      *******     ***** ***  ***           ***   
      **    **    **   ++ **  ***    ***    ****    ++   ***++     ************ +++ ***  *****   *  
  **   *  *******     *******       **    **    **          ***** +++  **  *    ***    ***    ***** 
       *                      ****      ****++**  ****    **    ***    ***        ****  * +++    ***
      **    ** ***    **    *+++     ************ +++ ***  *  **      +++++*****   ******      **** 
****   *    **++** *****    *+    *****++*** ***+   **    ******     ***** ***  ***           ***   
****      ****++**  ****    ******   *    **++** *****    *+****     ***** ***  ***           ***   
****     ***** ***  ***           ***    ***        ****  ******     ***** ***  ***       **  ***   
****               ***    **          **       ***                ***++*** ***+      *****+++    ***
      **    **    **   ++ **  ****    *****     ***    **   ++ ***  ********* +++ ***     +++   **  
    ***    ***        ****  * +++    ************ +++  **  *    ***    ***        ****  * +++    ***
    *****++*** ***+   **    ******      ****++**  ****    **+++    ************ +++  **  ****      *
      ***++*** ***+      *****+++    *******++*** +++  **  *  **      +++++*****   ******      **** 
++     ************ +++ ***  *****   *    **++** *****    *+    ***    ***        ****  * +++    ***
+++    ************ +++  **  *    **    *+++     ********** ++ ***  ********* +++ ***     +++   **  
****      ****++**  ****    **    **   ++ **  ****    *****         **      +++++*****   ******     
****     ***** ***  ***       ********** +++     *    **        ***    ***        ****  * +++    ***
+++    ************ +++  **  ****      ****++**  ****    ** ********        **      +++++*****   ***
** +++  **  *          **     ***   ++**    *     **    * **    ***    ***        ****  * +++    ***
****     ***** ***  ***       **  ***       **********        **      +++++*****   ******      **** 
****               ***    **        **  ****    ***      ***+++    ************ +++  **  ****      *
      **    **    **   ++ **  ***    ***    ****    ++   ***    ***    ***        ****  * +++    ***
  **      +++++*****   ******      ****  **     **      *+++****     ***** ***  ***       **  ***   
  **   *  *******     *******       **    **    **              ***    ***        ****  * +++    ***
       *                      ****      ****++**  ****    **++     ************ +++ ***  *****   *  
      **    ** ***    **    *+++     ************ +++ ***  *****     ***** ***  ***           ***   
****   *    **++** *****    *+    *****++*** ***+   **    **      ***++*** ***+      *****+++    ***
****      ****++**  ****    ******   *    **++** *****    *+****     ***** ***  ***           ***   
****     ***** ***  ***           ***    ***        ****  ******     ***** ***  ***       **  ***   
****               ***    **          **       ***              ***    ***        ****  * +++    ***
      **    **    **   ++ **  ****    *****     ***    **   ****     ***** ***  ***       **  ***   
    ***    ***        ****  * +++    ************ +++  **  *+++    ************ +++  **  *    **    
    *****++*** ***+   **    ******      ****++**  ****    **  **      +++++*****   ******      **** 
      ***++*** ***+      *****+++    *******++*** +++  **  *  **      +++++*****   ******      **** 
++     ************ +++ ***  *****   *    **++** *****    *+    ***    ***        ****  * +++    ***
+++    ************ +++  **  *    **    *+++     ********** +++    ************ +++  **  *    **    
****      ****++**  ****    **    **   ++ **  ****    ***** ++     ************ +++ ***  *****   *  
****     ***** ***  ***       ********** +++     *    **      **      +++++*****   ******      **** 
****               ***    **  * +++ ***  *****   *    **    +++    ************ +++  **  ****      *
      **    **    **   ++ **   ***           ***    *       ++     ************ +++ ***  *****   *  
    ***    ***        ****  * *******  **    **   ++ **  *******     ***** ***  ***       **  ***   
    *****++*** ***+   **    *********++    ************           ***++*** ***+      *****+++    ***
      ***++*** ***+      ******** ***+      *****  +++   ** ****     ***** ***  ***       **  ***   
++     ************ +++ ***  ********* +++ ***     +++   ** ****     ***** ***  ***           ***   
+++    ************ +++  **  ****      ****++**  ****    ** ++     ************ +++ ***  *****   *  
****      ****++**  ****    **   ++ **  ****    ***         ****     ***** ***  ***       **  ***   
****     ***** ***  ***       **  ***       **********      ****     ***** ***  ***           ***   
****               ***    **        **  ****    ***      ***    ***    ***        ****  * +++    ***
      **    **    **   ++ **  ***    ***    ****    ++   ***  **      +++++*****   ******      **** 
